模型预测结果：
文本：笑死	预测的类别为：legal
文本：平型关战役后我一直苟到45年，问就是游击战	预测的类别为：legal
文本：不如讨论下二战是苏联出力多还是美国出力多	预测的类别为：legal
文本：敌后战场和正面战场都很重要	预测的类别为：legal
文本：老师如果不驳斥，说不定明天你就能在微博上看到课堂录音了	预测的类别为：legal
文本：敌后战场也是战场啊	预测的类别为：legal
文本：是谁设置的非法抗日	预测的类别为：illegal
文本：如果按谁死的多谁就出力多，那kmt出力确实大啊！   你说kmt出力，不如说是爱自己国家的国民党有志之士出力。	预测的类别为：illegal
文本：出力多是指东北军一枪不放，孙元良淞沪南京两次跑路，爆破花园口，汪精卫当汉奸，不给新四军八路军军饷配枪还围剿新四军，豫湘桂被强弩之末打的找不到北吗？	预测的类别为：legal
文本：谁掌握了过去，谁就掌握了现在。谁掌握了现在，谁就掌握了未来。	预测的类别为：legal
文本：我正面不打，当然就不会被打的找不着北了	预测的类别为：legal
文本：具体问题具体分析，不能一概而论	预测的类别为：legal
文本：这是碰都不能碰的滑梯	预测的类别为：legal
文本：这个话题课堂上不宜讨论，不会有结果的	预测的类别为：legal
文本：nice try	预测的类别为：legal
文本：正面战场国民党主力军CPC自己史书认的	预测的类别为：illegal
文本："非法抗日"，这很CCP	预测的类别为：legal
文本：太NAIVE了，很符合我对新生的想象  楼主也是	预测的类别为：legal
文本：圣哲魏王，百褶微蔻	预测的类别为：legal
文本：说蒋光头战力弱，但ccp当时战力也不能跟日本比，怎么硬拼？蒋光头至少带人起到了填线的巨大作用。	预测的类别为：legal
文本：河南人表示光头真该死，蒋万安怎么不过来给我磕一个	预测的类别为：legal
文本：有没有可能他就是想在班级里找点鉴证好友	预测的类别为：legal
文本：那真是很好的寻找方式	预测的类别为：legal
文本：去大街上问估计会说中国出力多	预测的类别为：legal
文本：乐子人差不多得了，你既然觉得gmd出力多就拿出论据来讨论，水源又不是没有键政区。在这里发一句话就乐有什么意思	预测的类别为：illegal
文本：很快就能区分出成分	预测的类别为：legal
文本：苏武？屈原？蒋干？毛遂	预测的类别为：legal
文本：忘了降兵如毛，降将如潮是吧  在建立伪军方面确实出力多  谈游击的是不是也忘了国府方面也在打游击	预测的类别为：legal
文本：蒋光头是不是历史上的uzi  1.打服了所有人就是没打服喷子的嘴  2.感觉东北守不守无所谓啊，回家洗澡去了  3.要是早点安内不知道拿多少s赛冠军了  4.s8拿了一整年冠军最后被jkl摘桃子了  5.校长尽力了，手下将领都是cba  6.uzi喜欢咆哮流指挥，校长也喜欢指挥  7.uzi经常红温，校长也经常娘希匹	预测的类别为：legal
文本：Uzi罪不至此	预测的类别为：legal
文本：我很好奇老师是怎么驳斥你的？	预测的类别为：legal
文本：国民党军在二战中基本上是负作用  如果没有中国共产党领导的敌后抗战，  使日军不能从占领区获取维持战争的人力物力，经济崩溃，  难以想象日本帝国主义会铤而走险，走向南进论的不归路。	预测的类别为：legal
文本：看到直播了	预测的类别为：legal
文本：不是我 ，那同学刚说这一句话，就被老师一下子打断了，然后说你这是根本认知错误，什么碰都不能碰的滑梯之类的	预测的类别为：legal
文本：这么说一个是巧力，一个是蛮力？  这么说的话那应该属于五五开了   虽然我觉得其实巧力更重要。	预测的类别为：legal
文本：可以，顺便问问你柏林是不是米占领的	预测的类别为：illegal
文本：原话是这样吗	预测的类别为：legal
文本：uzi喜欢微操，平a一下要点4次地板，校长也喜欢微操	预测的类别为：legal
文本：传统武学讲究四两拨千斤	预测的类别为：legal
文本：有个问题，对日战争期间，中共和国党连体量都不是一个级别的，怎么比？	预测的类别为：legal
文本：这种贡献问题恐怕很难量化	预测的类别为：legal
文本：打正面好送人头是吧  你既然讨厌中共  你怎么不去跟他们打正面呢	预测的类别为：illegal
文本：出力确实很多，从非法抗日到炸花园口到皖南事变到大溃败，日本投降后还要靠美爹的运输能力抢占东北华北接收投降	预测的类别为：legal
文本：肯定不是维为老师的原话，意思就是这样	预测的类别为：legal
文本：意思是你揣测的还是他告诉你的？	预测的类别为：legal
文本：很难吗，我觉得楼主就成功量化了	预测的类别为：legal
文本：意外的发现是伪军居然人数快赶上日军了…   图片 1170×2532 355 KB   图片 1170×2532 232 KB	预测的类别为：legal
文本：我寻思这句话是有什么奥秘吗?有什么需要翻译的地方吗?	预测的类别为：legal
文本：同学，你在哪个位置，我们在一个教室呢	预测的类别为：legal
文本：这位同学的原话是什么，任课老师的原话是什么，他是怎么驳斥的，还需要我翻译的更具体一点吗	预测的类别为：legal
文本：抗战的牺牲是巨大的，但很多牺牲都是国民党导致的、本可以避免的白白牺牲。	预测的类别为：legal
文本：再看看高级陆军将领投敌的人数...  整个盟国没哪个有这么拉的，除了一开始就被干碎的髪国	预测的类别为：legal
文本：有点哈人了 这种问题怎么可能在课上讨论啊 毕竟头上三尺有神明 教室后面录着像呢	预测的类别为：legal
文本：打团打输了不要紧，韩信一直在带线偷塔偷野区，经济刷的比对面还高。关键是对面发现打了很多无效团，长沙会战几次没战果，家还被偷了一半，回防的人多了正面就输了（豫湘桂战役）。打到二十分钟场外因素开始干扰（苏联美国下场）。你能说韩信没用吗，没韩信这局早没了；你能说其他人没用吗，没长沙会战拖平，这局也早没了。综上，团队游戏，少了谁都不行。	预测的类别为：legal
文本：可以去看录像	预测的类别为：legal
文本：光头是uzi你是369？  是我对你太温和了还是你叛逆期了  一个赛季练一个原话这么难吗	预测的类别为：illegal
文本：二战，国、共、日、伪这四个方面的关系本来就很奇特，也很复杂，《色戒》可能比较好的表现了我的想法，但如果仅仅迹及不论心，中共做的比国党优秀太多了。国党仁人志士不仅不乏，而且还相当多，但是这不是被国党拿他们当炮灰的理由	预测的类别为：legal
文本：这跟哪个党关系很大吗？不是死的都是中国人吗？难道说被国民党强行征兵然后牺牲在抗日战场上的中国人的奉献就简简单单地被说成是国民党的功劳了？	预测的类别为：illegal
文本：是的，国民党仗着人多就会蛮干，共产党敌后切断敌方补给聪明很多，所以我觉得共党贡献大一点。因为切断补给的做法更关键，对战场的态势起了决定性作用。   国民党属于战术上的勤奋掩盖战略上的懒惰，而共党恰恰相反。   如果比 出力 ，那肯定国民党大一些。但是要比 贡献 ，那肯定共党大一点。	预测的类别为：legal
文本：我们看的就是录像！	预测的类别为：legal
文本：       广目无双:     共党       吓人	预测的类别为：legal
文本：这个同学说的那一句到底是什么，我好急，楼主拉扯这么久连句原话都不能提供吗	预测的类别为：legal
文本：原话就是“国民党出力多”这一句，是汉字的理解难度有点高么	预测的类别为：legal
文本：多怎么衡量？是更多还是最多还是单纯的多？老师是怎么“狠狠”驳斥的？“狠狠”驳斥的原话是什么？	预测的类别为：legal
文本：遇见低能的就该直接驳斥，还要等他发表长篇大论的低能吗	预测的类别为：legal
文本：你快别问了 要给楼主干流汗了！	预测的类别为：legal
文本：这老师懂不懂抗战我不知道，但他一定懂中共	预测的类别为：legal
文本：重新定义周四	预测的类别为：legal
文本：填线是指45年本子在太平洋都被打的找不着北了还能正面突破kmt？	预测的类别为：legal
文本：CD来了	预测的类别为：legal
文本：这是贴吧？	预测的类别为：legal
文本：要没之前填线，也坚持不到豫湘桂溃败的时候了	预测的类别为：legal
文本：要是艾跃进上课，这位同学就应该挂科了。	预测的类别为：legal
文本：我的建议是反对A就直接反对A，不要为了反对A去支持B，不然只会把自己弄的更抽象	预测的类别为：legal
文本：主力军是美国佬	预测的类别为：legal
文本：我最近在学习wzn的交流方式，化身	预测的类别为：legal
文本：这个问题可以用机会成本来理解。   对当时的中国来说，有两个极端的选择：由国民党领导全国抗战，和由共产党领导全国抗战。  众所周知，如果所有资源一样，毛泽东领导的共产党对蒋介石领导的国民党有摧枯拉朽般的优势。  所以在各if线中，最好的选择其实是让毛泽东领导的共产党领导全面抗战。  而另一个极端，即让蒋介石领导的国民党完全领导全面抗战，结局是否能比参杂了共产党活动的史实更好，这个就……   所以我个人倾向于，从绝对量上而言蒋是有贡献，但从最佳选择上而言蒋确实是负面影响。	预测的类别为：legal
文本：这叫中华民国国军	预测的类别为：legal
文本：首先，我没有读心的能力，你要是要发散自己去问发言的同学；其次，一个正常人听了之后只会记得大意而不是原话；然后，我没有求着你发表高见，你要是想听原话，那你自己去看录像	预测的类别为：legal
文本：就楼主这键政水平，我觉得挂的不亏	预测的类别为：legal
文本：你还觉得你有理了？这么严肃的话题下面就发了个笑死，你笑尼姆呢？	预测的类别为：illegal
文本：感觉现在你源已经成公交车了，反贼浓度过高以至于新生觉得拿什么话题都能当投名状用   image 1052×348 31.4 KB	预测的类别为：legal
文本：都别吵，都别吵（猪猪音）  我们还是讨论一下jkl和 有没有相似性	预测的类别为：legal
文本：所以你现在还在笑死状态吗	预测的类别为：illegal
文本：确实是这个道理  没有美国人卖给德日的资源，二战是谁跟谁打都不一定。	预测的类别为：legal
文本：既然都是抗战了，讨论哪个贡献多有什么意义吗，都是中华民族吧，我看抗战史时从来不把那些国民党将领看作敌人，哪个不都是在抛头颅洒热血，戴安澜、孙立人、王耀武	预测的类别为：legal
文本：我想说新生对感到奇怪的问题发表质疑是好的。但也别傻傻装外宾吧……公共场合发表这种言论会怎样你不应该不知道啊。结果只有一个。  如果实在想了解真相如何，建议自己通过各种渠道搜集史料，自行研究。  有时候分享欲应该收一收的。这是我在水源混迹一年后得出的惨痛教训。	预测的类别为：illegal
文本：你们不要害得我在国庆不能刷水源啊，魂淡	预测的类别为：legal
文本：谁是合法政府？谁拿着全国的税收？谁不给部队编织？只给两个番号？	预测的类别为：legal
文本：美：两边都下注，怎么输  如果站在日本的立场，我更倾向石原派，日本的体量，就算采取怀柔政策，也怎么吃得下中国？	预测的类别为：legal
文本：如何定义出力呢，如果只看伤亡数确实是国民党多，但南京会战，兰封会战(作战不力毙了一个将领)，武汉会战，长沙会战，豫南会战，这么多的正面大战，几乎每一场都没有达到战略目的，死伤掺重，贡献了海量的伪军。   如果这叫出力，那共产党敌后战场简直是天神下凡	预测的类别为：legal
文本：这下出力不出功了	预测的类别为：legal
文本：怎么定义出力？  出的力是按绝对总量计算还是按相对比例计算？  史料采用哪些？怎么论证观点？	预测的类别为：legal
文本：虽然我也不喜欢  ，但是抗日之后gmt越打人越少，他们越打人越多不是没原因的。踩一脚烂的不用捧更烂的	预测的类别为：illegal
文本：只能说，同样的兵，同样的装备，交给共产党带，可能就不用死那么多gmd将士了（他们也是别人的丈夫、别人的儿子、我们的同胞啊）	预测的类别为：illegal
文本：一般是坦克战士在前面抗伤害，刺客背后切C，射手躲在后面输出才行	预测的类别为：legal
文本：伪军容易招，日本陆军训练还是需要时间，而且本身日本摩托化程度高，调兵快，战损比也高，所以人数并不算很多。毕竟整个抗战小日子一共70w左右的伤亡	预测的类别为：legal
文本：“受降的都是国民党啊？”	预测的类别为：legal
文本：皖南事变杀了新四军数千精兵这个债怎么算	预测的类别为：illegal
文本：感觉不如德国的亲密战友苏苏，法国战役后向面对盟国封锁的德子雪中送炭，41年美国对日减出口90％石油的时候与日续签五年贸易协定。假如不与发动侵略战争的国家立刻断绝贸易往来就算最大责任方，那原来是    在进攻乌克兰，当年也是    在进攻伊拉克	预测的类别为：legal
文本：不好评价。   但是我觉得要遵守两条原则。  第一是凡事讲证据，不能在这靠着自己零碎的记忆和臆想去揣测事件的全貌，可以有立场，但是不能有先入为主的偏见。  第二是对于官方的话全盘接受是愚蠢的，同样的对于上边的观点一概否定是自大自傲的表现。	预测的类别为：legal
文本：KMT就算正面被打出shit那他也是主力，它菜不菜跟它是不是主力是没有什么逻辑关系的。扯什么花园口豫湘桂模糊观点不是搞笑么？	预测的类别为：illegal
文本：皖南事变也是主力 抗线抗不住 喜欢卖队友 打团也不来的废物，把把挨举报信誉分掉光也不冤	预测的类别为：illegal
文本：日本训练，重武器装备和kmt差距挺大的，加上校长喜欢微操，线不是那么容易抗住的。当然汤伯恩有装备还豫湘桂大溃退是没得洗	预测的类别为：legal
文本：举个更具体的例子，淞沪会战打完损失了二十多万，整个东南精兵基本打的一干二净，但好在是拖住了日军进攻的脚步，我们算国党干得好，出了大力气。   但淞沪会战打完，日军登陆杭州湾了，好呗，我们英明的国党准备15万(包括三万多还是四万新兵蛋子）对20万机械化日本军队固守南京一到两个月，一直吵到十一月中旬才戒严战备，仍然有五十余万居民没有疏散，该做固守工事的没有做完备。   好呗，南京城十天告破，震惊中外的南京大屠杀就发生在这次战役……可怜三十余万同胞 。   如果出力气是这样，我宁愿他们不出力气。正面战场战略游离不定，全党上下弥漫机会主义思想。反观国共内战保卫延安，高下立判，谁是谁非不言自明	预测的类别为：legal
文本：这种话题不要看中文媒体，简体字和繁体字占各一方。没必要为了黑而黑，为了平反而平反，去看看敌人的评价，和盟友的评价。	预测的类别为：legal
文本：讨论了几百楼也没人来贴个数据。   IMG_20230925_115422 3890×868 530 KB   IMG_20230925_115500 3576×878 314 KB  （2和3分别是国共双方自己给出的杀敌数字）  只看杀敌的话或许是国民党出力多吧。  但是就像楼上有同学提到的，国民党在正面战场上取得的种种战绩，代价是什么呢？	预测的类别为：legal
文本：真理愈辩愈明。越是这种话题，越可以看出来我们身边隐藏的敌人	预测的类别为：legal
文本：这个逻辑有点...那啥  歪楼警告      总结   举个不恰当例子，按这个逻辑我也能声称xxx在疫情防控中起了主要作用，但很明显源u会把我冲烂	预测的类别为：legal
文本：       CR400AF:     皖南事变       所以解放战争被平推了，KMT被封号属于历史的必然性。	预测的类别为：legal
文本：A一下就开始长跑的正面是吧	预测的类别为：legal
文本：       杰洛特:     不与发动侵略战争的国家立刻断绝贸易往来就算最大责任方       好一手断章取义   米帝英法把德日养肥了之后，开始甩锅给苏联了。苏联当初找英法限制洗头佬的时候，英法已经把“洗头佬快去打苏联”写到脸上了	预测的类别为：legal
文本：出力还要看百分比，你本身能出多少力，实际出了多少，cpc那段时间一直是超常发挥，而果党是根本没有出全力的决心和表现的	预测的类别为：legal
文本：你只听了个大意你讨论啥呢？大意是真实的老师想表达的大意还是你揣测的大意  你让别人看录像，别人又没上这门课也不知道是谁的课怎么看录像？你自己能看录像，看完发个原话这么难？	预测的类别为：illegal
文本：就kmt的政治体系，结构和派系而言，他注定无法和cpc一样爆种，你指望买办和共产主义战士比那没得比。不过和kmt的上层等美国平推相比，kmt的中下级军官还是有不少抗战志士的，有不小贡献	预测的类别为：illegal
文本：所以这种话题本身就很复杂，xxx作为唯一合法ZF他必须是抗疫主力，不然你根本选不出真正的抗疫主力是谁，但事实上它要是22年不搞那一手封的操作，光看19-21这两年我觉得可以打90分，说是抗疫主力没啥问题，但22年感觉是换了个人指挥一样像是被夺舍了。	预测的类别为：legal
文本：孙中山在的时候还是受人称赞的，但后来独裁者来了，就拉了，我说的gmd	预测的类别为：legal
文本：又被干出CD了 xs	预测的类别为：legal
文本：所以批判的点就在于kmt的体系 结构 派系和阶级性，以至于中下层的抗战志士能力没有得到最大的发挥，也就是“无法出力”	预测的类别为：legal
文本：难道李云龙打掉坂田联队指挥部，劫杀日本将官观摩团，消灭山崎大队，解放平安县城都是假的吗？	预测的类别为：legal
文本：kmt牺牲是个人觉悟，gcd牺牲是民族大义！	预测的类别为：illegal
文本：现场前排cy	预测的类别为：legal
文本：少话，种鸦片中	预测的类别为：legal
文本：大清已经掌握住将来了吧	预测的类别为：legal
文本：我根本不是这个意思。	预测的类别为：legal
文本：好像当时是有同学就抗日战争胜利的思考题进行发言时，在提及“坚持...的正确领导”之后，现场出现低笑，老师表示不满，认为大家需要绷紧某根弦不松动，期间陆续有同学就国党问题发言。感觉理解的分歧在“领导”这个词上。	预测的类别为：legal
文本：我宣布，这是个不可证，不可知问题，散会	预测的类别为：legal
文本：史实有对错，叙事（或者说神话）无对错。讨论中不能混淆这几个，不然后果很严重。   像出力大还是不大，这是一个主观的问题；主观的问题没有对错，也没必要强求他人去认同。   我觉得大学生有时间都该读读《历史三论》，区分一下事件、经历和神话，免得受到教科书的影响总是把史实和神话混作一谈，客观事实和价值判断分辨不清。	预测的类别为：legal
文本：我看有些人没受教科书的影响也没分清楚嘛	预测的类别为：legal
文本：说白了还是价值判断的问题  一句话总结就是：“搞成这样也配xx？”	预测的类别为：legal
文本：要不是有国军将士的抗争，我们能有今天？听说还有个谁谢谢日本侵略，不然当局没法夺权，我cao它laomu	预测的类别为：legal
文本：常维为教授也来了啊	预测的类别为：legal
文本：是这本吗？   IMG_20230925_125828 1080×708 121 KB  已经在我今年的书单上了	预测的类别为：legal
文本：莫非你觉得蒋光头能干的比现在好？如果维持日本入侵前的状况现在一只鸡切几块也不知道	预测的类别为：illegal
文本：吓人	预测的类别为：legal
文本：听说特朗普被狗日了	预测的类别为：illegal
文本：日本法西斯本意是坏的，但在二战各方的战斗中给执行好了，这是“感谢”一词的来由。另外你所深恶痛绝的人虽然势单力薄但从一开始就坚持抗日，直到中日和解的时候才在私下场合用感谢一词，另一方一直妥协退让直到全面入侵，之后也还在不断谈判乞和，直到美国下场才勇敢梭哈，那你该怎么办呢？	预测的类别为：illegal
文本：我刚刚也想说这个例子，感觉水源人只能看得懂喜闻乐见的 例子   不过说到中共的领导，其实也是有的，要是没调停，万一杨虎城和张学良真把校长做掉了那也挺抽象的	预测的类别为：legal
文本：我一开始是真不知道这句话谁说的，知道后就把我上一条撤了	预测的类别为：legal
文本：哈哈，被源友骂了吧，傻逼	预测的类别为：legal
文本：小张嘛，人怂一点，倒不傻，没有慈父授意绑不了蒋公	预测的类别为：illegal
文本：ChatGPT，把下面内容的“奥本海默”替换为“抗日时期的中国共产党”，把“美国听证会”替换为“水源审判会”           圣母，完美受害人以及被审判的巨人——观《奥本海默》   影视品论          首先，自爆叠个甲，以下内容没有数据，只有身边统计学  在我上高中以前，看到的电视剧一般都会出现两派泾渭分明的阵营，一边是不为个人私利的英雄、圣母与白莲花的阵营A，另一边是只为一己私欲做事的恶徒、暴徒与阴谋家的阵营B，他们之间斗智斗勇，最后大多是阵营A战胜了阵营B。如果最后阵营A没有战胜阵营B，那么一定是这个最后的后面还有更加最后。典型代表包括但不限于西游记、射雕英雄传、神探狄仁杰、变形金刚、复仇者…	预测的类别为：legal
文本：       来了吗？:     调停       和领导差距还是蛮大的吧。   名义上肯定是民国政府领导，民国政府=中国国民党吗	预测的类别为：legal
文本：要断章取义 ——《不要断章取义》	预测的类别为：legal
文本：是我断章取义了，我是真不知道这句话的来源。  也有可能其他人也说过这些？我看到的可能是其他人说的，并不是这个来源	预测的类别为：legal
文本：我还是喜欢你刚才愤怒的样子，麻烦恢复一下谢谢	预测的类别为：illegal
文本：你看到的可能是反串黑的说法	预测的类别为：legal
文本：要辩证的看待问题，历史书上那么多事件，好像几乎都是有好有坏的分析。   只有坏的分析，好像只有文革。	预测的类别为：legal
文本：他说是谁说的了吗？我线下也听过有人这么说来着	预测的类别为：legal
文本：这就是水源	预测的类别为：legal
文本：银帕摁开，女学生嗯	预测的类别为：legal
文本：一知半解的情况下，最好是再学一学，了解了解   交大国务学院专业的政治学课程，可旁听	预测的类别为：legal
文本：我现在都怀疑你是wzn小号了	预测的类别为：illegal
文本：不知道，但感觉可能是个软体动物说的。应该除了嘴巴是硬的，其他地方都是软的	预测的类别为：legal
文本：战争时期党派博弈还得记个kda方便后世复盘？	预测的类别为：legal
文本：资治通鉴	预测的类别为：illegal
文本：为什么不怀疑我是wzn小号  我都这么努力模仿了	预测的类别为：legal
文本：扯淡吧  你不如说爱这片土地的人出力多  你要说爱国，那大家爱的是什么国？那个时候可没有PRC  人民是深爱着这片土地的，爱国情怀只是一种集中体现	预测的类别为：legal
文本：毕业了还考虑毕业旅行是吧	预测的类别为：legal
文本：可能太刻意了？  不够自然？  wzn主打就是一个天然萌	预测的类别为：legal
文本：人家就是想找个靶子狠狠输出情绪，你怎么还给人分析上了呢	预测的类别为：illegal
文本：@Ananas_comosus_Merr  来看	预测的类别为：legal
文本：别删啊哥 我不删了	预测的类别为：legal
文本：让我们问问chatgpt吧   老师指出同学的看法为错误认知可能是因为 这个观点过于简化了抗日战争的复杂性 。抗日战争是中国历史上的一场极为艰苦和漫长的战斗，国民党和共产党都为抗击日本侵略做出了重要贡献，而且在不同的时期和地区承担了不同的角色。因此，要全面评估两者的付出和贡献，需要考虑以下几个方面：     地域分布：在抗日战争初期，国民党控制了中国的大部分城市和沿海地区，因此国民党在这些地区承担了重要的责任。共产党则在一些偏远山区和乡村建立了抗日根据地，起到了游击战的作用。   抵抗力量的建立：共产党在抗日战争初期就开始建立了八路军和新四军等抗日武装力量，而这些力量在后来的战斗中发挥了重要作用。   抗战胜利的协作：国共两党虽然在政治上存在分歧，但在抗日战争中进行了一定程度的合作，共同抵抗日本侵略。抗日联盟框架下的合作对战争的胜利也起到了重要作用。   重要战役和事件：共产党在一些关键战役中也发挥了重要作用，如百团大战和平津战役等。而国民党也在一些战役中付出了巨大努力，如淞沪会战和台儿庄战役。     综合来看，抗日战争的胜利是国共两党以及其他中国各界人民共同努力的结果，不能简单地归因于任何一方。因此，同学的看法可能被老师打断是因为这种简化观点无法全面反映抗日战争的实际历史情况。抗日战争是众多人民和组织共同努力的结果，值得继续深入学习和研究。	预测的类别为：legal
文本：       年糕:     同学的看法可能被老师打断是因为这种简化观点无法全面反映抗日战争的实际历史情况       没说完被打断，是因为简化，你倒是给时间让同学深化啊。	预测的类别为：legal
文本：chatgpt比老胡还能搅混水，这种问题问它没有什么意义。人工智能的知识来自人类自己。	预测的类别为：illegal
文本：你怎么知道他还要继续深化	预测的类别为：legal
文本：抗日战争有平津战役是吧，ai还是naive           年糕:     如百团大战和平津战役等	预测的类别为：legal
文本：赛后复盘	预测的类别为：legal
文本：不知道啊	预测的类别为：legal
文本：坏了，我成日本人了	预测的类别为：legal
文本：出力又不一定做正功，可能不做功，甚至做负功	预测的类别为：legal
文本：汪精卫点个赞？	预测的类别为：legal
文本：那为什么内战是国民党开始的？	预测的类别为：illegal
文本：难绷	预测的类别为：legal
文本：       21世纪是生物的世纪（不是:     国军死伤惨重       国军打得烂，一方面因为买办军阀脱离人民，另一方面因为蒋介石菜。蒋介石抓壮丁、贪污、打压非嫡系部队、包庇孙元良这种出生、先把东北送了、又在淞沪战场把精锐部队送了。这不死伤惨重就有鬼了。          21世纪是生物的世纪（不是:     别扯什么敌后战场了，八路军和新四军说白了就是保存实力为内战做准备       同学对战争的基本认识是什么？  对后勤和战时经济有概念吗？  八路军新四军为内战做准备？谁知道日本鬼子一定会输，抗战一定会赢？  不如说说蒋介石在珍珠港事件之后才敢对日宣战，都已经抗战十年了。  倒是kmt那边保存实力的例子很多啊，蝈军不动如山是出了名的吧。	预测的类别为：legal
文本：战争不就是F2A吗	预测的类别为：illegal
文本：对于楼上来说还真是这样	预测的类别为：legal
文本：剿匪都剿到台湾去了	预测的类别为：legal
文本：重庆谈判不是谈好了？共党地位那里面还是明确的，可以有军队。	预测的类别为：legal
文本：你这是得了孙哥真传了	预测的类别为：illegal
文本：我记得当时看史纲，里面说抗日分三个阶段，战略防御阶段，战略相持阶段和战略反攻阶段（这个说法好像是教员的观点）。战略防御阶段是国民党是主力，后两阶段是共产党，特别是战略防御阶段时国民政府有亲美派和亲日派……难评。	预测的类别为：legal
文本：那现在中华人民共和国是合法政府，能不能也合法剿剿匪	预测的类别为：legal
文本：得国之正，莫如吊民伐罪，民国合法性在花园口、金圆券等知名操作下已经洪川东逝，更不用说TG为工农团体掀开历史新一页了。	预测的类别为：legal
文本：合吗？	预测的类别为：legal
文本：活久见，反贼不给造反	预测的类别为：legal
文本：刷到这里，我认为当下更有意义的问题是如何打败张鹏	预测的类别为：legal
文本：论文标题都歪了，内容还用去看？   你说国民党在抗日战争中发挥了重要的作用  你说国民党在正面战场发挥主要作用    你说国民党在抗日战争中起主要作用 应该不太对吧	预测的类别为：illegal
文本：围墙包围学校，....	预测的类别为：legal
文本：对岸民国年鉴都承认中共在抗战中占主导，当然当时形势是三方博弈	预测的类别为：legal
文本：1946年6月26日，国民党在完成战争准备后，不顾全国民众的强烈反对，撕毁停战协定和政协决议，以围攻鄂豫边宣化店为中心的中原解放区为起点，相继在晋南、苏皖边、鲁西南、胶济路及其两侧、冀东、绥东、察南、热河、辽南等地，向解放区展开大规模的进攻，全面内战爆发。   到底是谁发动的内战   历史虚无主义差不多得了	预测的类别为：legal
文本：按你说的早有准备，为啥还千里挺进大别山  那不是早就该准备好了吗	预测的类别为：legal
文本：       小布小安:     历史虚无主义差不多得了       就你发的前面那段狗屎话，你还没整明白历史	预测的类别为：illegal
文本：请他去菁菁堂开个会，把他保镖留门外	预测的类别为：legal
文本：拿不出反驳证据是这样的，无能地人身攻击恰恰说明了你的无力	预测的类别为：illegal
文本：我们需要美团的援助	预测的类别为：legal
文本：哥们你这发言太典了	预测的类别为：legal
文本：真以为自己匿名啊，搞笑，拉黑咯	预测的类别为：legal
文本：别说了 来感觉了	预测的类别为：legal
文本：∠的还不够多啊，建议先剿百匪	预测的类别为：legal
文本：快进到         【转自知乎】炫富学生领取贫困生奖学金     这个帖子不再回复了要喷随意	预测的类别为：legal
文本：歪楼警告      总结   我是觉得这楼完整展示了一下皇俄是怎么来的...	预测的类别为：legal
文本：Poll in France: Which country contributed the most to the defeat of Germany in 1945? : r/europe --- 法国的投票：哪个国家对1945年德国战败贡献最大？：r/欧洲 (reddit.com)     的确要警惕美国媒体对世界人民的洗脑，对历史的篡改。	预测的类别为：legal
文本：大家都忘了刚刚过去的疫情之间发生的事了吗？修改历史是正常操作。	预测的类别为：legal
文本：有一部分苏联解体，而美国国力增长的因素在吧	预测的类别为：illegal
文本：有没有台湾的同学，想知道台湾的历史课本是如何讲的	预测的类别为：legal
文本：我自由法兰西呢	预测的类别为：legal
文本：加上意大利，也轮不到加你法兰西	预测的类别为：legal
文本：？你读的是哪个平行世界的历史故事	预测的类别为：legal
文本：呃呃，果党那水平现在能承认有贡献已经很不错了，我都嫌阿共大度。果党在抗战中的表现前期尚可，后期暴露出来的问题简直无法直视，不忍卒读。   中共在抗战中起到的作用你不看官方史料，看日、美两国当时的资料也是能看出来的   中共游而不击当时就是汪伪政权散布的汉奸言论，我不希望在水源上还看到这种水平的发言	预测的类别为：legal
文本：你说得对，但这就是水源	预测的类别为：legal
文本：众人皆醉他独醒	预测的类别为：legal
文本：       Aggregation:     有没有台湾的同学，想知道台湾的历史课本是如何讲的       找到了一些电子教材。关于中国近代史的内容可以参考这里:  https://sites.google.com/view/sanminhistorybook2/高一自學霸/歷史第二冊110/第二冊第六章   当然，有的内容比较那个，但是我可没搬全书过来啊，大家也别搬全书过来，号重要。      相关章节（仅涉及二战相关内容）                         后面比较劲爆不搬了。	预测的类别为：legal
文本：在某个已经消失的人的博客里看过类似的观点	预测的类别为：legal
文本：魏收：喵喵喵？	预测的类别为：legal
文本：看看台湾人的教科书，和中国台湾省俩up主的观点。   蒋中正未完全放弃武力统一中国   image 1274×602 140 KB	预测的类别为：legal
文本：我最爱在这种楼里通过点赞的贴表情分辨大伙屁股所在，有一种苦主和女友打电话聊了半天女主终于憋不住刺激喘了一下被识破的快感	预测的类别为：legal
文本：台省讨厌常凯申可是比大陆还要更甚的	预测的类别为：illegal
文本：猜猜我是（	预测的类别为：legal
文本：就喜欢ntr，多说点	预测的类别为：legal
文本：那你读的是什么，勾史？	预测的类别为：illegal
文本：       21世纪是生物的世纪（不是:     胜利者编的秽史       那失败者的推锅大会很好看吗？	预测的类别为：legal
文本：直接进真理部	预测的类别为：legal
文本：反作用就不是作用了吗？  看不起花园口战神？	预测的类别为：legal
文本：益言丁真，鉴定为痴史的东西	预测的类别为：illegal
文本：图片 1170×2532 271 KB   图片 1170×2532 252 KB  我在写小说的时候整理了大量的史料，不可否认，第三卷也就是抗日时期的篇幅大部分都是国军的，但是值得注意的是，前期很振奋人心，后期打得稀烂	预测的类别为：legal
文本：前期光头的江浙老巢丢完了，小鬼子马上进陪都了，他可不就拼命了吗？  后期他美爹下场了，光头把脚跟站稳了，就开始琢磨继续剿共搞摩擦了。后期光头打的几次战役，不是因为被动挨打，就是为了“国际观瞻”。  蒋系抗日啥也不是，鉴定为一坨勾史	预测的类别为：legal
文本：有没有可能，是光头真的菜	预测的类别为：legal
文本：怎么还没收敛啊  无聊，我要看到血流成河	预测的类别为：legal
文本：这楼里的内容给我看笑了，也不需要历史/军事知识吧  但凡打过一点rts或者moba游戏，你也该知道  没队友硬刚正面拉扯，你偷个屁的家，偷个屁的信使，断个屁的兵，分分钟tp回来你就死了	预测的类别为：legal
文本：收收味	预测的类别为：legal
文本：但凡打过一点rts/moba游戏，就知道，没有偷家的队友，你得多爆多少人口的一本炮灰，才能正面刚过对面的二本部队 云玩真下头	预测的类别为：illegal
文本：我觉得光信使已经把我的成分暴露的很明显了吧	预测的类别为：legal
文本：刀斯林show show way	预测的类别为：legal
文本：您就是标准的打团永远不在，一问就在带线拉扯偷家，然后还要怪队友送的太多是吧  你没意识到你的回复跟我的回复逻辑根本不存在矛盾关系吗	预测的类别为：illegal
文本：各司其职啊，非要说国民党出力多也没错，毕竟还有这么一种解读方式:国党出的力是好的，但下面用错了地方 ，蒋委员长尽力了带不动	预测的类别为：legal
文本：呃呃，复习一下忻口战役和太原战役？  八路打团的时候一直在c，阎长官队频指挥也老老实实照办了，奈何阎长官和蒋委员长一直拉稀，把团打崩了。一直到日军滚起雪球，团不了了，阎长官和蒋光头缩在高地不敢出来了，八路上单去带线，这时候你终于腾出手了，可以反过来公屏打字骂八路不参团是吧？  太乐了，家人们。   再提一句，八路打上单一直是孤儿路经济，兵线还是你蒋委员长带头蹭光的，你老几位吃了经济打不出输出，怎么回事捏？	预测的类别为：legal
文本：正面我刮民党出力最多，歼敌一亿，虎踞重庆	预测的类别为：legal
文本：高地王者罢了	预测的类别为：legal
文本：但你用了moba游戏，我们dsl都说类dota的	预测的类别为：legal
文本：所以我说了蒋光头就是uzi，一人我吃四路，团战我零输出	预测的类别为：legal
文本：我去，人参公鸡	预测的类别为：legal
文本：疑似攻击性过强	预测的类别为：legal
文本：你的素质，确实很适合在国军里面当“军爷”，这就是你和国军官僚共情的原因吗	预测的类别为：illegal
文本：我反建制也不会沦落到支持果党去，上面那顶个熊头的果粉确实是个dinner	预测的类别为：legal
文本：可能他的某些亲属是果党配出来的	预测的类别为：legal
文本：水源水平低到还有人给kmt招魂  是图kmt年纪大？还是不洗澡？另外前面说土八路游而不击的，我寻思冈村宁次搁那折腾他那比扫荡为了啥？找借口向大本营打报告要军费？	预测的类别为：legal
文本：个别源u认为自己比冈村宁次更懂战争	预测的类别为：legal
文本：水平差是这样的	预测的类别为：illegal
文本：10分钟队友全退，小小要单排1V5先知超级兵翻盘	预测的类别为：legal
文本：历史没有如果  37年的时候ccp刚长征结束，就剩两三万人了，留在南方的后来的新四军也就一万人，同期的国民革命军一般认为有两百万左右，要不是日本人和张学良，ccp基本就算交代了  在那个时候只可能由蒋介石领导。  至于ccp之后展现的神奇操作，那是后话了。  在那个时间节点上，就是一个只剩一口气的反政府武装	预测的类别为：legal
文本：抗战国民党出力多，不等于起主要作用吧	预测的类别为：legal
文本：怎么定义出力多，怎么定义主要作用	预测的类别为：legal
文本：所以要等后面深化吧	预测的类别为：legal
文本：怎么深化，你能开个头吗	预测的类别为：legal
文本：我不知道，所以等	预测的类别为：legal
文本：等待戈多	预测的类别为：legal
文本：        军事理论课一人说抗战国民党出力多，直接被老师狠狠驳斥   谈笑风生          没说完被打断，是因为简化，你倒是给时间让同学深化啊。	预测的类别为：illegal
文本：然而到现在也没有深化，令人感叹	预测的类别为：legal
文本：歪个楼，对两党有不同心理倾向的可能是家里的原因   日本人都没拿你家东西，结果和平了你家被抄了总不能舔着脸说他好吧   归根究底还是立场不同，谁都吵不过谁	预测的类别为：illegal
文本：是我的错，忽略了这个细节。如果揪字眼的话。的确是这样    好比推车，力用错了方向，造成的效果不好，不代表他出力不多。     用moba游戏来比喻就是刷了送，输出经济比太低。	预测的类别为：legal
文本：没有，一多半税收在日本呢，或者说在汪精卫那里	预测的类别为：illegal
文本：人民的选择	预测的类别为：legal
文本：        军事理论课一人说抗战国民党出力多，直接被老师狠狠驳斥   谈笑风生          出力又不一定做正功，可能不做功，甚至做负功	预测的类别为：legal
文本：是的，你不能说他没用力，这倒是实在话	预测的类别为：legal
文本：兄弟阋于墙 外御其侮	预测的类别为：legal
文本：熊头果粉属实难绷	预测的类别为：legal
文本：历史当然可以讲没有如果。  你讲的不是日本人和张学良（这也是一种如果），共产党就交代了，这一点我就觉得存疑。  回过头看那两个人，即使没有抗战，我也完全不相信蒋介石能打败毛泽东。  而且如果你所说的前提是真的，实力差距能量化到5：200，一口气就能消灭，张学良为什么要促成第二次合作呢？   如果不需要抗日，蒋介石固然可以全力围剿，继续推进他这么多年都没达成的目标。  然而到延安之后，中共上层已经对毛泽东完全服气，恐怕直到这时毛泽东才能真正发挥全部实力。  蒋介石能打赢解封完全体实力的毛泽东？	预测的类别为：illegal
文本：  其实这种磨擦，除了根本原则不计外，其种子已包藏于联合之最初时期，即两党对于联合之方式，都未免鲁莽：一方面国民党未能抛弃招降的态度，一方面共产党在政治上事事迁就允诺，未能坦白的坚持自己抗日的政治主张，因此事后在政治态度及宣传上，引起了国民党对共产党有言行不符的疑虑。一切磨擦便自然的日渐发生了。  此种磨擦如果双方都感觉有停止的必要，下列办法或者可以收相当的效果：  一、国民党承认共产党及其他在野的党派，都公开的合法存在，要求他们合力抗日，而不取招降的态度；并且不妨碍在野党对政府党政治的批评。  二、共产党及其他党派，都以在野党的资格绝对拥护抗日战争；一致承认国民党一党政权及其对于抗日战争之军事最高统率权这一事实，不要把开放党权和开放政权混作一谈。  在原则上，政治上的争论，有可能推动政治进步，直接间接有利于抗战。非政府党党员在政府附属机关担任工作，这本与政权无关。政府对于所属机关之用人，应采人材主义，不必一党包办，在野党亦应避免政府附属机关中地位之竞争；非政治的斗争即地位斗争，有百害而无一利。各党各派如果把民族利益放在党派利益之上，这种斗争是应该停止的。党派间以至一党中小派别之非政治的无原则的地位斗争，只有为敌人开辟道路！  1938年2月19日 《血路》第六期 署名：陈独秀	预测的类别为：legal
文本：       匿名匿名匿名:     张学良为什么要促成第二次合作呢       藩王一般活不久	预测的类别为：legal
文本：       司同学你看到可怜酱了吗:     日本人都没拿你家东西，结果和平了你家被抄了总不能舔着脸说他好吧       如果只认屁股不讲道理，我的建议是直接图了	预测的类别为：illegal
文本：       hammer:     历史没有如果       历史没有如果  但是如果能帮助我们做分析   他讲的不是如果，而是逻辑	预测的类别为：legal
文本：你站在上面也得	预测的类别为：illegal
文本：笑了，教科书直接说一百万部队溃败	预测的类别为：illegal
文本：壮志青天耀白日，血浸山河满地红   出力肯定是出力的，多不多我不知道	预测的类别为：legal
文本：这种比谁出力多贡献大是一个有很强现实暗示作用的辩题，但这不是一个严谨的历史问题。从理论上来说，抗战期间的各路军阀、包括敞篷车都是有国民革命军编制的，甚至蒋介石得以在抗战期间借此大义整编了大量军阀部队	预测的类别为：legal
文本：韩信在干嘛？   韩信在偷塔	预测的类别为：legal
文本：       匿名匿名匿名:     你讲的不是日本人和张学良（这也是一种如果），共产党就交代了，这一点我就觉得存疑。       如果张学良不兵谏，东北军中下层军官就起义投共了，共产党一样交代不了，当时东北军对蒋不抗日却沉迷剿共的不满已经无法压制，张学良很大程度上也是不得不发	预测的类别为：legal
文本：       匿名匿名匿名:     蒋介石能打赢解封完全体实力的毛泽东？       毛泽东又不是神。如果不考虑苏联，红军长征已经折损大量实力了，蒋介石要是继续打，一来可以长征到哪，二来还能损失多少？	预测的类别为：illegal
文本：不用打问号，光头也就指挥得动中央军  长征的时候不止一次地方军阀给红军让路防老蒋趁机吞并的，可谓防蒋甚于防共	预测的类别为：legal
文本：国民党很多优秀的抗日将领，在抗日战场上有巨大的贡献，比如薛岳，比如张自忠，比如李宗仁，比如缅甸远征军的戴安澜、孙立人等。这些人也不全是蒋的嫡系，他们作为正面战场的主力做出了巨大的贡献，他们领导的国军将士也做出了巨大的贡献和牺牲。共方同理。  这个要割裂开来看，国军比共军贡献大，但是领导的国民党显然贡献不如共产党大。  能在世界大反攻的时候打出豫湘桂，实在丢脸。旁边的英国人什么韦维尔、亚历山大、斯利姆之前在东南亚也是一路跑，可同时期却能打出英帕尔这种胜仗。  还有什么花园口，堪比明末的操作，国民党能够逼得老百姓去帮日军，领导层怎么看都使得国军将士和老百姓付出了许多不必要的牺牲	预测的类别为：legal
文本：是这样的，蒋光头确实是个打仗的弱智，但不能否认国民党将士在正面战场作出的巨大牺牲与贡献。当然可以说共产党在敌后游击做出了很大的贡献，但是有人说共军作用比国军大这个我就有点忍不了了，小粉红也不至于这样无知吧。他们知道第三次长沙会战是太平洋战场上盟军取得的首次胜利吗？他们知道鄂西会战胡琏第十八军第十一师死守石牌才保住三峡隘口使得重庆没有门户大开吗？他们知道长衡会战中国民革命军第十军以17000人固守孤城抵御日军十一多万人47天，并最终打出了1:3的战损比吗？他们知道中国远征军为了保卫唯一的陆上国际援助道路滇缅公路损失了将近20万人吗？他们不知道，他们只知道国民党不行，只知道蒋光头左移10米的微操，而否认无数爱国将士的牺牲，实在是有些可笑了	预测的类别为：illegal
文本：       homelander:     链       琏          homelander:     石牌       成功虽无把握，成仁确有决心	预测的类别为：legal
文本：收手吧阿祖，你源品客就这样	预测的类别为：legal
文本：不好意思打太快打错了	预测的类别为：legal
