模型预测结果：
文本：      微信公众平台         12月份新批国产网络游戏版号数量过百 持续释放支持网络游戏行业繁荣健康发展的积极信号             今天，国家新闻出版署发布了新批准的105款国产游戏版号，单次审批数量首次突破百款，所涵盖的游戏企业范围也更广，中国音像与数字出版协会游戏工委和广大游戏企业深受鼓舞。   这次新批版号，是继12月22日新批准一批进口网络游戏版号后，国家新闻出版署又批准发布的一批国产网络游戏版号，有力展示了主管部门积极支持网络游戏发展的鲜明态度。   国家新闻出版署和游戏产业网的统计信息表明，2021年全年发放游戏版号748款，其中国产672款，进口76款；2022年全年发放游戏版号512款，其中国产468款，进口44款；2023年截至目前发放游戏版号1075款，其中国产977款，进口98款。三年的数据表明，版号政策的稳定性逐步增强，游戏市场回升明显。   今年以来，版号的稳定核发，稳步增长让广大游戏企业吃了“定心丸”，如今游戏企业更多地将精力放在市场探索、模式创新、自研创新和科技创新等方面，并积极开拓海外市场。伴随着版号的“常态化+大力度”获批节奏，游戏的精品化正日益成为企业高质量发展的主流趋势。   近年来，中国游戏产业发展迅速，取得了令人瞩目的成绩。最新发布的《2023年中国游戏产业报告》显示，今年国内游戏市场实际销售收入首次突破3000亿关口，用户规模再创新高，达到6.68亿。   游戏工委希望广大会员单位以此为契机，努力推出更多精品，推动网络游戏行业高质量发展，为促进文化繁荣发展，建设文化强国贡献力量。	预测的类别为：legal
文本：屎拉裤子里知道擦了	预测的类别为：illegal
文本：简直像个笑话	预测的类别为：legal
文本：   获批游戏列表   image 888×14497 2.21 MB     真是游游又戏戏啊，你们有没有这样的游戏啊？	预测的类别为：illegal
文本：全都是12.25批的，加急处理是吧	预测的类别为：legal
文本：幽默	预测的类别为：legal
文本：糟了，让下面尝到甜头了，以后天天闹事，不满意就一个板块跌停	预测的类别为：legal
文本：时间：12月25日	预测的类别为：legal
文本：礼拜一一大早发版号  这下知道急了	预测的类别为：legal
文本：有些人是真的贱 怎么都有角度 所以还是原罪论是吧	预测的类别为：illegal
文本：其实也不尽然，我看以往的时间基本都在22-26号左右，少数月份是月初批的，不过这种宣传力度还是闻所未闻。	预测的类别为：legal
文本：猜你喜欢：   IMG_20231225_101814 1080×204 66.1 KB	预测的类别为：legal
文本：Paradigm:Reboot	预测的类别为：illegal
文本：       2023:     今年国内游戏市场实际销售收入首次突破3000亿关口       一部征求意见稿就能跌4000亿，你不服气吗	预测的类别为：legal
文本：现在应该不止了	预测的类别为：legal
文本：出版署：金融口的同志们我知错了，在老大面前饶了我吧	预测的类别为：legal
文本：范式：起源！  现在有两个音游源神了	预测的类别为：legal
文本：昏招连连步步错！	预测的类别为：legal
文本：我的评价是好比给自己创死的人坟前烧五块钱肯德基代金券  我发版号≠我要改，传达出的信息依然是这个  但凡对提振市场信心有一点用也不至于一点用都没有	预测的类别为：legal
文本：港股今天要是没休市，网易是不是还得跌	预测的类别为：legal
文本：老大：好！我正好进货了。中投的同志们听好，给我顶上去，顶到四块半，然后全部放掉！	预测的类别为：legal
文本：什么连	预测的类别为：illegal
文本：给我接下一句	预测的类别为：legal
文本：奥利安安汉汉好	预测的类别为：legal
文本：哈利路路旋旋风	预测的类别为：legal
文本：好恶心啊，真的好恶心啊，实在是真的好恶心啊	预测的类别为：illegal
文本：image 1246×375 50.8 KB   坏了！	预测的类别为：legal
文本：这下欢乐爆爆爆了	预测的类别为：legal
文本：佳绩频频局局赢winwinwin	预测的类别为：legal
文本：不是，会涨	预测的类别为：legal
文本：具体点，有角度啥，我怎么没听懂。   这和原罪论有啥关系，闹笑话就是闹笑话，这几个部门是脑弹不是公认的嘛。反倒是无条件维护的反而像另一种角度的原神论 。   如果你觉得这两天这几个部门的举动是一套有理智的行政管理系统做出来的。那我只能祝愿你今后所有的上司和管理你的人都是这种货色 。	预测的类别为：legal
文本：此帖子已被社区举报，现已被临时隐藏。	预测的类别为：legal
文本：此帖子已被社区举报，现已被临时隐藏。	预测的类别为：legal
文本：一眼望去感觉全是咸鱼之王衍生游戏	预测的类别为：legal
文本：本来不想展开，你非要这么说我就多说点  上周看新闻出版署的网站上11.17的公告：  《国家新闻出版署关于实施网络游戏精品出版工程的通知》  然后上周发了关于游戏的那个文件，一群人都说铁拳（只说现象，具体内容保留意见），是打击游戏行业了  发版号的行为是每个月固定的，有时候迟点有时候早点，规律大家都看得见，所以版号多发了很多，也是打击游戏行业？还是觉得过了个周末又开始找补了，自己打自己脸？那版号停发/少发，你们又要怎么叫？   结合这个“精品出版工程”的铺垫，我的理解是整治下国内游戏长期劣币驱逐良币，捞快钱割韭菜，导致大家要玩精品的游戏、3A就只能大量给国外送钱，并不是要 彻底砍掉 游戏行业，从版号多发能看出来释放了积极信号，也就是不是砍游戏行业，而是引导   本来只是单纯觉得，有些狗多发/少发/停发 都要叫，多发了都叫，少发停发是不是把狗窝都掀了	预测的类别为：legal
文本：一百多坨  进去就给你弹出各种充值	预测的类别为：illegal
文本：脑弹是公认的，所以干什么都是脑弹，怎么都不行，这不叫原罪叫什么？到底谁脑弹了	预测的类别为：illegal
文本：槽的真是哪里都有公式啊，真的是大明星啊，你们有这样的传播度吗我就问你们	预测的类别为：legal
文本：我看你这言论水平和那几个署差不多  至于我是在说你好还是不好  你觉得好就是好  你觉得不好就是不好  我看你觉得挺好的	预测的类别为：illegal
文本：因为这个事情本来就不该瞎管。   你写的内容都基于你的臆想，你要多了解点实际情况就写不出这样的话来。   是不是找补，不看部门内部怎么沟通，难道看你脑补？   你看不到游戏公司里的接到的上级相关部门通知不代表所有人听不到。	预测的类别为：illegal
文本：       铁血赤音党:     不看部门内部怎么沟通       所以部门内部跟你沟通了？没有的话你是不是脑补？  游戏公司接上级部门通知跟我们讨论的发版号狗叫有关系吗	预测的类别为：illegal
文本：要是我说鹅厂网易都接到上级通知了，你会在这里当场道歉？	预测的类别为：legal
文本：我说的是部门内部沟通，不是上级部门通知，你两句话难道不是两件事  还是说你说的“部门”是游戏公司部门，我以为你说有关部门	预测的类别为：illegal
文本：你不是说这不是找补吗？你不是觉得版署不在乎风波吗？	预测的类别为：legal
文本：发版号是正好这几天发，宣传阵仗搞大点是给前几天找补，“释放积极信号”的说法是对的，“持续释放积极信号”就有点不要脸了	预测的类别为：legal
文本：我也没说持续释放啊	预测的类别为：legal
文本：Image_1703474596933 964×292 48.2 KB   确实不是找补，你说得都对。	预测的类别为：legal
文本：       铁血赤音党:     你不是觉得版署不在乎风波吗？       这个能找出我的原话？	预测的类别为：illegal
文本：       qaplagzy:     我的理解是整治下国内游戏长期劣币驱逐良币，捞快钱割韭菜，导致大家要玩精品的游戏、3A就只能大量给国外送钱       严重怀疑他是不是真的这么想的	预测的类别为：illegal
文本：有没有可能我也没回复你，回复的是主贴呢……	预测的类别为：illegal
文本：无限火力！	预测的类别为：legal
文本：唉，监管倒闭Jing Pin化	预测的类别为：legal
文本：逻辑是，版署不道歉也不找补，那不就是不在乎嘛。	预测的类别为：legal
文本：@Sophon  速来扩充训练集	预测的类别为：legal
文本：什么ai沈阳美食家	预测的类别为：legal
文本：沟槽的训练集真是幽幽又默默啊	预测的类别为：legal
文本：太搞笑了，搞得像欧美3a多是因为g胖联合大厂合理推动立法ban了每日签到的垃圾网游实现的一样，酱紫推动精品？	预测的类别为：legal
文本：光是让某些游戏不引进让大家都能玩  就已经是劣币驱逐良币了	预测的类别为：illegal
文本：好经典的逻辑，逻辑就是虚空帮别人编话？  本来就不可能道歉，这个不谈；  我是说如果有人觉得多发的版号在找补，比如本来打算发N-50个，现在看不对劲发了N个，周末加班突击审50个，就为了找补，是不是有点不太合理？强行脑补因果？  你截图的宣传阵仗，确实我看了下上个月没这阵势，如果说这个宣传行为是在增强信心/找补，我认为是合理的	预测的类别为：illegal
文本：差不多得了，一竿子打死真有你的	预测的类别为：illegal
文本：       qaplagzy:     我是说如果有人觉得多发的版号在找补，比如本来打算发N-50个，现在看不对劲发了N个，周末加班突击审50个，就为了找补，是不是有点不太合理？强行脑补因果？       这个没人知道，但是你也是在脑补啊，我觉得突击加班的概率明显更大啊。   后面你说的是对的。   版号数量其实根本无所谓，重要的是这几个部门同时做到了低能又傲慢。	预测的类别为：legal
文本：所以你“觉得”我“觉得”没有任何意义，不能作为论据，结果你还在“觉得”，所以明显不明显，概率大不大，不评价  但这倒不至于没人知道，你能知道腾讯网易当然就有人知道有关部门的一些情况  版号的话，垃圾版号多与少确实没有本质区别，但是版号多了，发版号从上个月的迟发到这个月的按时发、提前发，确实是积极信号啊，2天之内从“消极”到“积极”，一定要把它理解为反复横跳，还是确实是有明确意图的引导，这个保留意见	预测的类别为：illegal
文本：不过说实话，水源的偏建制派也是相对有逻辑的，这个讨论环境真是难得...   这两天在贴吧大战，回来火气有点重，先浅浅道个歉。	预测的类别为：illegal
文本：道歉？不存在的   唯一的可能就是被经济部门按着头，不情不愿的表态，目的是“提振市场信心”，和行业健康发展没有半毛钱关系  一点表态都没有的话央妈和证监会能把出版署办公楼掀了信不信    （看这个工作作风，怕是经济口周末已经掀了一次办公楼了）	预测的类别为：legal
文本：笑点解析：     1、“游戏工委和广大游戏企业深受鼓舞”：这里有点让人想笑，因为通常我们说“深受鼓舞”的时候，往往是因为一些积极的、令人振奋的消息。但是，游戏工委和游戏企业是应该知道游戏版号被批准的，所以这里的“深受鼓舞”可能是有点夸张了。   2、“有力展示了主管部门积极支持网络游戏发展的鲜明态度”：这句话也有一些夸张的成分。通常，版号的批准是主管部门正常的工作流程，但在这里被描述为“积极支持网络游戏发展的鲜明态度”，给人一种感觉像是主管部门在为网络游戏行业打气。   3、“三年的数据表明，版号政策的稳定性逐步增强，游戏市场回升明显”：这里的数据显示，版号政策确实在逐渐稳定，但说“游戏市场回升明显”可能有点过于乐观了。毕竟，版号政策的稳定并不一定意味着游戏市场就会回升。   4、“如今游戏企业更多地将精力放在市场探索、模式创新、自研创新和科技创新等方面”：这句话给人一种感觉，好像游戏企业之前没有做过这些事情，现在才开始做。但实际上，这些都是游戏企业一直在做的事情。   5、“游戏的精品化正日益成为企业高质量发展的主流趋势”：这句话有点绕，给人一种感觉像是官方在给游戏企业“洗脑”，让他们都去做精品游戏。但实际上，游戏的精品化是企业自身发展的选择，而不是被强迫的。   6、“今年国内游戏市场实际销售收入首次突破3000亿关口，用户规模再创新高，达到6.68亿”：这句话给人一种感觉，好像中国游戏市场的发展是理所当然的，但实际上这背后有很多复杂的原因和因素。   7、 数字的对比 ：文中提到2021年全年发放游戏版号748款，2022年全年发放游戏版号512款，而2023年截至目前发放游戏版号1075款。通过这种逐年对比的方式，产生了一种“版号数量在逐渐减少，但2023年突然爆发”的幽默效果。   8、 “精品”化的比喻 ：文中提到游戏的精品化正日益成为企业高质量发展的主流趋势，将“精品化”比喻为企业发展的“主流趋势”，这种表述方式增加了文字的趣味性。     总的来说，这段文字中有些地方可能会让人觉得有点夸张或者绕口，但这也是为了让读者更好地理解中国游戏产业的发展状况。令人忍俊不禁。	预测的类别为：legal
文本：出版署与其指望发了点版号来提振信心，不如让人信服地解释一下之前为什么很长一段时间没发版号以及以后会不会又突然不发版号了，否则发版号岂不是和罗辑那个心跳威慑一样，只是起到不让信心突然崩溃的作用罢了	预测的类别为：legal
文本：你觉得他们能理解这点吗	预测的类别为：legal
文本：雷霆雨露，俱是天恩！	预测的类别为：legal
文本：这些年反反复复的房地产、教培、游戏、疫情……能看出某些人是真的没什么水平	预测的类别为：legal
文本：一句话 瞎折腾	预测的类别为：legal
文本：治大国如烙大饼，糊了翻个面怎么了？至于这么冷嘲热讽吗？	预测的类别为：legal
